┌────────────┬────────┬─────┬────────┐
│            │        │     │        │
│                     │     │        │
├────────────┘        └─   ─┤        │
│                           │        │
│                           │        │
│                           │        │
├──    ─────────────────────┘        │
│                                    │
│                                    │
│                                    │
│                                    │
│                                    │
└────────────────────────────────────┘