┌────────────┬────────┬─────┬─────┬────────┐
│            │        │     │     │        │
│                     │     │     │        │
├────────────┘        └─   ─┤     │        │
│                           │     │        │
│                           │     │        │
│                           │     │        │
├──    ─────────────────────┘     └─      ─┤
│                                          │
│                                          │
│                                          │
│                                          │
│                                          │
└──────────────────────────────────────────┘